"id","label","parent","obsolete"
"1","1ERE","","0"
"2","2NDE","","0"
"3","3EME","","0"
"4","4EME","","0"
"5","5EME","","0"
"6","6EME","","0"
"7","BTS1","","0"
"8","BTS2","","0"
"9","CAP1","","0"
"10","CAP2","","0"
"11","CE1","","0"
"12","CE2","","0"
"13","CM1","","0"
"14","CM2","","0"
"15","CP","","0"
"16","TERMINALE","","0"
